






     XXXXXX       X    X    XXXXXX   X
     X    X       X    X    X    X   X
     X    X       XXXXXX    XXXXXX   X
     X    X       X    X    X    X   X
     XXXXXX       X    X    X    X   X
                                                 P    C
                                              XXXXXXXXXXXXX         
                                       H                     
                                     XXXXX                   
                                 XXXXXXXXX                   
                             XXXXXXXXXXXXX                   
                         XXXXXXXXXXXXXXXXX                   
         T          XXXXXXXXXXXXXXXXXXXXXX   G          G                                         %
XXXXXXXXXXXXXXXXXXXXXXXXXXXXXXXXXXXXXXXXXXXXXXXXXXXXXXXXXXXXX      X       X      X       X       X