                                                             
                                                             
                                                             
                                                             
                                                             
             H           H                                   
         XXXXXXX       XXXXX                C                
            X          X    X              XXX               
            X          XXXXX                                 
        X P X          X    X         XX                     
         XXX     X     X     X   X      X                    
                                                $     KK     
                                              XXXXXXXXXXXXX         
                                       H                     
                                     XXXXX                   
                                 XXXXXXXXX                   
                            XXXXXXXXXXXXXX                  
    X         X          XXXXXXXXXXXXXXXXX                   
    X    S    X  T  XXXXXXXXXXXXXXXXXXXXXX   G          G  
XXXXXXXXXXXXXXXXXXXXXXXXXXXXXXXXXXXXXXXXXXXXXXXXXXXXXXXXXXXXX